┌─────────┬──────────┐
│         │          │
│         │          │
│         │          │
│         │          │
│                    │
│         │          │
│         │          │
│         │          │
│         │          │
└─────────┴──────────┘
