┌─────────┬──────────┐
│         │          │
│         │          │
│         │          │
│         │          │
│     P              │
│         │          │
│         │          │
│         │          │
│         │          │
└─────────┴──────────┘
