┌──────────┬──────────┐
│          │          │
│          │          │
│          │          │
│                     │
├─────────   ─────────┤
│                     │
│          │          │
│          │          │
│          │          │
└──────────┴──────────┘
