┌──────────┬───────┐
│P         │       └──┐
│          │          │
│                     │
│         ┌─┐         │
├───────  │■│  ───────┤
│         └─┘         │
│                     │
│          │          │
│          │          │
└──────────┴──────────┘
