┌────────────────────┐
│P                   │
│                   ┌┘
│                   │
│                   │
│                  ┌┘
│                  └┐
│                   │
│                   │
└───────────────────┘